1111111111111111111111
1c001c00000c000000c1c1
1000100000000011111101
111c1000000c0000000001
1110000011111111111101
1c1c1000000000001011c1
1c001111111000101011c1
1000000c000p0010100001
10000000001110001c0001
1000001111100011111001
100000100E100c00001001
1011001000111111001001
10c1000000000000001001
10c110000c111111c01cc1
1111111111111111111111