111111111111111111111111111111
1c01c00100000000c00000000000c1
1c111001000000c1c0001111111111
10000001c010011111000000000011
100000010010000c00000000000001
100000010c10000000111110000001
100100011110000000100100000001
100100000000000001100111110001
100100000000010011110000000001
100100000000010011111100000001
1001001110000100cc000111111001
1001c00c1011100001100000001001
100111111000100001000000001001
11c100110000cc0001000111111001
111100110000100001000001000001
1c0100000000100p01000001000001
100100001111111111111111100001
100100000100000100000000000001
10000011000000110000c000c00001
10011111001100cc111111111110c1
1c000c110011000000000c000000E1
111111111111111111111111111111